10
16
level1.png
75
200
·   D##  · #####
###· ##    ·· @#
###  ##   ·    #
 ··  ##  #######
###  ##  #######
#### ##        #
 V     ·    #   
#### #   ##   # 
·    #   # ### ·
### ·#   #     #